6 8
.......A
....B...
.A......
.....B..
.B......
....A...
